#####################
@ #   #   #   #     #
# # # # # # # # ### #
#   # # #   #   #   #
##### # ######### ###
#   #   #     # #   #
# ### # ### # # ### #
# #   #     #     # #
# # ### ########### #
# #   # #           #
# ### ### ######### #
#         #         K
#####################