#####################
#@      #       #   #
####### # ##### # # #
#   #   #   #T# # # #
### # ##### # # # ###
#  T#       # #   #T#
# ### ####### ##### #
#                 # #
# ### ############# #
#   # #   #   #     #
### # # # # # # #####
#   #   #   #      K#
#####################