#####################
#@#   #   #   #     #
# # # # # # # # ### #
#   # # #T  #   #   #
##### # ######### ###
#   #   #     # #   #
# ### # ### # # ### #
# #   #     #    T# #
# # ### ########### #
# #   # #           #
# ### ### ######### #
# T       #        K#
#####################