#####################
#@      #       #   #
####### # ##### # # #
#   #   #   #T# # # #
### # ##### # # # # #
#   #       # #   # #
#T### ####### ##### #
#                 # #
# ### ############# #
#   # #   # T #     #
### # # # # # # #####
#   #   #   #      K#
#####################