#####################
#@  #         #T    #
### # ### ### # ### #
# # # #   #T# # # # #
# # # # ### # # # # #
# # # # #   # # #   #
# # ### ### # ### ###
# #     #   #   #   #
# ####### ### # ### #
# #   #   #   #   # #
# # # # # # ##### # #
#  T#   #       #  K#
#####################