#####################
S   #         #     #
### # ### ### # ### #
# # # #   # # # # # #
# # # # ### # # # # #
# # # # #   #   #   #
# # ### ### ##### ###
# #     #   #   #   #
# ####### ### # ### #
# #   #   #   #   # #
# # # # # # ##### # #
#   #   #       #   E
#####################