#####################
#@  #         #T    #
### # ### ### # ### #
# # # #   # # # # # #
# # # # ### # # # # #
# # # # #   #   #   #
# # ### ### ##### ###
# #     #  T#   #   #
# ####### ### # ### #
# #   #   #   #   # #
# # # # # # ##### # #
#  T#   #       #  K#
#####################