#####################
#@  # #T        # T #
### # # ##### # # # #
# # # # #     # # # #
# # # # # ##### # # #
# # #   # #   # # # #
# # ##### # # # # # #
# #   #   # # # # # #
# ### # ##### # ### #
#   #   #     #   # #
# # ##### # ##### # #
# #   T   #        K#
#####################