#####################
#@        #         #
# # ##### ####### #T#
# #   # #       # # #
# ### # ####### ### #
#   # #       #     #
### # ####### ##### #
# # #     #     T # #
# # ##### # ####### #
# # T   # #   #   # #
# ##### # # # # # # #
#         # #   #  K#
#####################