#####################
#@        #T        #
# # ##### ####### # #
# #   # #       # # #
# ### # ####### ### #
#   # #       #     #
### # ### ### ##### #
# # #     #     T # #
# # ##### # ####### #
# # T   # #   #   # #
# ##### # # # # # # #
#         # #   #  K#
#####################