#####################
#@  #   #           #
### ### # ### ##### #
# #   # # #T#   #T  #
# ### # # # ### #####
#   # #       # #   #
# ### # ####### # # #
# #   #   #   #   # #
# # ####### # # ### #
# # #     # # # #   #
# # # ### # # ### # #
# T   #     #     #K#
#####################