#####################
#@#   #     #      T#
# # # # # # ##### ###
#   # #T# #     #   #
##### ### ##### # # #
#     #   # #   # # #
# ##### ### # ##### #
# #     #   #       #
# # ##### ######### #
# # #     #   #   # #
# # # ### # # # # # #
#   #  T#   #   #  K#
#####################