#####################
#@      #T    #     #
####### ##### # ### #
#    T#     #   #   #
### # ##### # ### # #
#   # #     # #   # #
# ##### ##### # ### #
#   #   # #  T# #   #
### # ### # ### # ###
#   # #       #     #
# ### ####### # ### #
#               #  K#
#####################