#####################
#@          #       #
########### ####### #
#  T#           #   #
# ### # ######### ###
#   # #         #   #
### # ##### ####### #
#   # # T # #   #   #
# ### # # # # # #T###
#   #   # #   #     #
# # ##### ##### ### #
# #           #    K#
#####################