#####################
#@          #       #
########### ####### #
#               #   #
# ### # ######### ###
#   # #         #T  #
### # ##### ####### #
#   # # T # #   #   #
# ### # # # # # # ###
#   #   # #   #     #
# # ##### ##### ### #
# #T          #    K#
#####################