#####################
#@    #           # #
##### # ####### #   #
#   #   #   #T  ### #
# # ### ### ### # # #
# #T#     #     # # #
# ### # ######### # #
#     # #       #   #
# ##### # ##### # ###
#   #   #    T# #   #
### # ####### # #####
#   #         #    K# 
#####################