#####################
#@    #           # #
##### # ####### #   #
#   #   #   #T  ### #
# # ##### # ### # # #
# #T#     #     # # #
# ### # ######### # #
#     # #       #   #
# ##### # ##### # ###
#   #   #    T# #   #
### # ####### # ### #
#   #         #    K# 
#####################